30 16
1 1 1 1 1 1 1 1 1 1 1 1 1 1 1 1 1 1 1 1 1 1 1 1 1 1 1 1 1 1 
0 4 4 4 4 4 4 4 4 4 4 4 4 4 4 4 4 4 4 4 4 4 4 4 4 4 4 4 4 0 
1 4 1 5 4 4 4 4 4 1 1 4 1 4 4 4 4 1 4 1 1 4 4 4 4 4 5 1 4 1 
1 4 1 1 4 4 1 2 4 1 5 4 1 1 4 4 1 1 4 5 1 4 2 1 4 4 1 1 4 1 
1 4 4 4 4 4 1 1 4 1 4 4 4 1 4 4 1 4 4 4 1 4 1 1 4 4 4 4 4 1 
1 4 4 1 1 4 4 4 4 4 4 4 4 4 4 4 4 4 4 4 4 4 4 4 4 1 1 4 4 1 
0 4 4 4 1 4 4 4 4 1 1 1 4 4 4 4 4 4 1 1 1 4 4 4 4 1 4 4 4 0 
1 4 4 4 4 4 4 4 4 4 4 1 1 1 1 1 1 1 1 4 4 4 4 4 4 4 4 4 3 1 
1 4 4 4 4 4 4 1 1 1 4 1 4 4 4 4 4 4 1 4 1 1 1 4 4 4 4 4 4 1 
0 4 4 4 1 4 4 4 4 4 4 4 4 4 4 4 4 4 4 4 4 4 4 4 4 1 4 4 4 0 
1 4 4 1 1 4 4 4 4 1 4 4 4 1 4 4 1 4 4 4 1 4 4 4 4 1 1 4 4 1 
1 4 4 4 4 4 1 1 4 1 5 4 1 1 4 4 1 1 4 5 1 4 1 1 4 4 4 4 4 1 
1 4 1 1 4 4 1 2 4 1 1 4 1 4 4 4 4 1 4 1 1 4 2 1 4 4 1 1 4 1 
1 4 1 5 4 4 4 4 4 4 4 4 4 4 4 4 4 4 4 4 4 4 4 4 4 4 5 1 4 1 
0 4 4 4 4 4 4 4 4 4 4 4 4 4 4 4 4 4 4 4 4 4 4 4 4 4 4 4 4 0 
1 1 1 1 1 1 1 1 1 1 1 1 1 1 1 1 1 1 1 1 1 1 1 1 1 1 1 1 1 1 
